language,type,lexicon,grammar,lexicon_grammar,avg_ms_complexity
mandarin,base-10,10,0,10,1.147948301362413
abun,base-10,10,1,11,1.2138802158431754
tagalog,base-10,10,1,11,1.160181585938607
hindi,base-10,10,3,13,1.1513370228516635
greek,base-10 w/ monomorphemics,11,0,11,1.1266920365285642
garo,base-10 w/ monomorphemics,11,6,17,1.147948301362413
yakut,base-10 w/ monomorphemics,12,0,12,1.1161959315568555
english,base-10 w/ monomorphemics,12,0,12,1.129342812308858
russian,base-10 w/ monomorphemics,11,0,11,1.1416924802438424
turkish,base-10 w/ monomorphemics,14,0,14,1.1057869028512777
cahuilla,base-10 w/o some digits,6,0,6,1.2822441661168458
kunama,base-10 w/o some digits,6,1,7,1.2822441661168458
kayahli,base-10 w/o some digits,6,4,10,1.3416467617090115
quileute,base-10 w/o some digits,6,1,7,1.2822441661168458
tarahumara,base-10 w/o some digits,8,4,12,1.2003281812245292
kannada,base-10 w/o some digits,9,3,12,1.171665583112185
khanty,base-10 w/o some digits,10,3,13,1.1449024038882527
georgian,base-20,11,0,11,1.1344328896245228
ingush,base-20,11,2,13,1.1344328896245228
abkhaz,base-20,10,0,10,1.1848592914836502
huave,base-20,11,1,12,1.1661852594300812
lezgian,base-20,12,0,12,1.1240238609189452
yucatec,base-20,12,2,14,1.1684239563599383
mixtecA,base-20,12,0,12,1.1272398032057676
mixtecC,base-20,12,1,13,1.130197916777627
french,base-20,11,4,15,1.1302796820375158
albanian,base-20,11,4,15,1.147948301362413
otomi,base-20 w/o some digits,7,1,8,1.2922161208365246
gola,base-20 w/o some digits,7,1,8,1.2635220721750142
arawak,base-20 w/o some digits,6,2,8,1.393565761884173
kana,base-20 w/o some digits,8,0,8,1.2171911935529025
nahuatl,base-20 w/o some digits,8,1,9,1.2625461565262213
diola,base-20 w/o some digits,8,0,8,1.2307937867206626
supyire,base-20 w/o some digits,8,0,8,1.2573708294515893
drehu,base-20 w/o some digits,8,4,12,1.3313988670727828
mangab-mbula,base-20 w/o some digits,6,4,10,1.509415539678581
haida,other bases,10,4,14,1.150409318278336
kilivila,other bases,6,1,7,1.356441083945599
tommoso,other bases,11,0,11,1.1462290570952343
khalaj,other bases,14,2,16,1.1057869028512777
artificial_language_g0_7,artificial,3,0,3,1.6170999788234846
artificial_language_g0_63,artificial,5,0,5,1.3351199405674379
artificial_language_g0_63_m3,artificial,4,0,4,1.4341301685559908
artificial_language_g1_39_m3,artificial,6,0,6,1.2703712509947587
artificial_language_g1_39_m3_m4,artificial,7,0,7,1.2242230128235094
artificial_language_g5_17,artificial,9,0,9,1.1668949620775686
artificial_language_g0_7_m6,artificial,2,0,2,2.0785225869763164
artificial_language_g5_17_m9,artificial,10,0,10,1.147948301362413
artificial_language_g5_17_m10,artificial,8,0,8,1.192078867659985
artificial_language_g7_6_m8_m20,artificial,15,2,17,1.086594271541131
artificial_language_g5_17_m9_m29,artificial,11,0,11,1.1331518384047088
artificial_language_g10_34_m24_m29,artificial,23,2,25,1.0457574285358826
artificial_language_g7_6_m9_m27_m29,artificial,17,2,19,1.072803024456161
artificial_language_g7_6_m9_m27_m29_m34,artificial,16,2,18,1.0783894635182707
artificial_language_g10_34_m24_m25_m36,artificial,21,2,23,1.052572838370948
artificial_language_g10_34_m24_m25_m35_m40_m41_m45,artificial,18,2,20,1.0666931159348327
artificial_language_g10_34_m24_m29_m52,artificial,24,2,26,1.0427696027014923
artificial_language_g10_34_m24_m25_m35_m40_m41_m53,artificial,19,2,21,1.0614451044182507
artificial_language_g5_17_m9_m29_m57,artificial,12,0,12,1.113900997146836
artificial_language_g7_6_m8_m20_m59,artificial,14,2,16,1.097226325849565
artificial_language_g0_13_m1_m2_m6_m21_m42_m57_m59_m65,artificial,27,2,29,1.0374840506580143
artificial_language_g0_13_m1_m2_m6_m9_m18_m33_m40_m67,artificial,25,2,27,1.04075237949505
artificial_language_g0_13_m1_m2_m6_m21_m25_m42_m44_m50_m51_m60_m69,artificial,28,2,30,1.0367810285462349
artificial_language_g5_17_m9_m29_m57_m84,artificial,13,0,13,1.1077609715730408
artificial_language_g10_34_m24_m25_m35_m40_m41_m53_m59_m91,artificial,20,2,22,1.0568792196611283
artificial_language_g0_13_m1_m2_m6_m21_m25_m42_m44_m50_m51_m60_m69_m94,artificial,29,2,31,1.0343300501622215
artificial_language_g0_13_m1_m2_m6_m21_m25_m42_m44_m50_m51_m52_m72_m77_m88_m94,artificial,30,2,32,1.0355814847667582
artificial_language_g10_34_m24_m25_m36_m97,artificial,22,2,24,1.049313444173379
artificial_language_g0_13_m1_m2_m6_m21_m42_m57_m59_m65_m98,artificial,26,2,28,1.0389386623793218
artificial_language_g0_0,artificial,19,0,19,1.0733402993782803
artificial_language_g0_1,artificial,18,0,18,1.1355895703418863
artificial_language_g0_2,artificial,25,0,25,1.0482276063271712
artificial_language_g0_3,artificial,12,2,14,1.132705927168235
artificial_language_g0_4,artificial,19,4,23,1.188047690260066
artificial_language_g0_5,artificial,19,2,21,1.071474754319929
artificial_language_g0_6,artificial,12,2,14,1.1541488462401701
artificial_language_g0_7,artificial,3,0,3,1.6170999788234846
artificial_language_g0_8,artificial,15,0,15,1.1153436410256965
artificial_language_g0_9,artificial,9,2,11,1.2266700889385656
artificial_language_g0_10,artificial,17,0,17,1.1287076445052722
artificial_language_g0_11,artificial,23,2,25,1.096809281250226
artificial_language_g0_12,artificial,10,0,10,1.5926122921935713
artificial_language_g0_13,artificial,26,2,28,1.0441678519366175
artificial_language_g0_14,artificial,23,3,26,1.1023361988904326
artificial_language_g0_15,artificial,14,0,14,1.208721639729379
artificial_language_g0_16,artificial,12,7,19,1.5166320318482158
artificial_language_g0_17,artificial,19,2,21,1.0735667660979091
artificial_language_g0_18,artificial,19,5,24,1.1646714368198068
artificial_language_g0_19,artificial,21,2,23,1.0862907413843224
artificial_language_g0_20,artificial,14,0,14,1.1758754553869912
artificial_language_g0_21,artificial,14,0,14,1.119452349883652
artificial_language_g0_22,artificial,16,1,17,1.1146704722702034
artificial_language_g0_23,artificial,23,0,23,1.0711213309268943
artificial_language_g0_24,artificial,14,6,20,1.2096377321227765
artificial_language_g0_25,artificial,15,0,15,1.1864525182560692
artificial_language_g0_26,artificial,24,0,24,1.0573720775703357
artificial_language_g0_27,artificial,12,2,14,1.1321203594588907
artificial_language_g0_28,artificial,11,1,12,1.181139858315409
artificial_language_g0_29,artificial,26,0,26,1.049919590440574
artificial_language_g0_30,artificial,15,2,17,1.1916195929931963
artificial_language_g0_31,artificial,20,0,20,1.073684334266538
artificial_language_g0_32,artificial,17,0,17,1.0791584391395903
artificial_language_g0_33,artificial,17,3,20,1.2202723824753228
artificial_language_g0_34,artificial,23,2,25,1.0563232631208714
artificial_language_g0_35,artificial,11,0,11,1.3050272737883621
artificial_language_g0_36,artificial,28,4,32,1.087840465310959
artificial_language_g0_37,artificial,14,0,14,1.1718114522013199
artificial_language_g0_38,artificial,24,0,24,1.0594395122064273
artificial_language_g0_39,artificial,15,0,15,1.115213817912357
artificial_language_g0_40,artificial,20,0,20,1.0826390930611014
artificial_language_g0_41,artificial,9,0,9,1.285675224804846
artificial_language_g0_42,artificial,8,1,9,1.2111933748102883
artificial_language_g0_43,artificial,29,0,29,1.0508409487278128
artificial_language_g0_44,artificial,20,0,20,1.0742986667776302
artificial_language_g0_45,artificial,12,0,12,1.3590485102510674
artificial_language_g0_46,artificial,17,0,17,1.103593236403728
artificial_language_g0_47,artificial,24,0,24,1.0481467082346403
artificial_language_g0_48,artificial,8,0,8,2.001874400365436
artificial_language_g0_49,artificial,23,2,25,1.0551038870970957
artificial_language_g0_50,artificial,16,0,16,1.1756669437684484
artificial_language_g0_51,artificial,18,5,23,1.1201873509626845
artificial_language_g0_52,artificial,10,0,10,1.2513201791197237
artificial_language_g0_53,artificial,10,2,12,1.268870791302187
artificial_language_g0_54,artificial,20,0,20,1.0678759790132268
artificial_language_g0_55,artificial,9,0,9,1.3966238331118577
artificial_language_g0_56,artificial,17,0,17,1.0963067429406248
artificial_language_g0_57,artificial,17,0,17,1.1059078072527675
artificial_language_g0_58,artificial,22,0,22,1.069532433767358
artificial_language_g0_59,artificial,25,5,30,1.1158611922399382
artificial_language_g0_60,artificial,21,0,21,1.0692125318022065
artificial_language_g0_61,artificial,22,0,22,1.057497984492949
artificial_language_g0_62,artificial,12,0,12,1.16289468904039
artificial_language_g0_63,artificial,5,0,5,1.3351199405674379
artificial_language_g0_64,artificial,18,0,18,1.0840013976352432
artificial_language_g0_65,artificial,17,0,17,1.0911068774706227
artificial_language_g0_66,artificial,26,0,26,1.058279594400582
artificial_language_g0_67,artificial,19,3,22,1.1493910612435687
artificial_language_g0_68,artificial,26,0,26,1.0526683406478106
artificial_language_g0_69,artificial,19,5,24,1.221611781043673
artificial_language_g0_70,artificial,14,2,16,1.2539379473163916
artificial_language_g0_71,artificial,8,0,8,1.3169558223966022
artificial_language_g0_72,artificial,12,7,19,1.3227392444525832
artificial_language_g0_73,artificial,19,2,21,1.0799538641388682
artificial_language_g0_74,artificial,23,4,27,1.1057503349673734
artificial_language_g0_75,artificial,19,0,19,1.080708181250223
artificial_language_g0_76,artificial,15,0,15,1.148523898523117
artificial_language_g0_77,artificial,9,7,16,1.463333860253035
artificial_language_g0_78,artificial,15,0,15,1.1257557478764844
artificial_language_g0_79,artificial,22,2,24,1.0670946164619894
artificial_language_g0_80,artificial,15,4,19,1.2545467496922635
artificial_language_g0_81,artificial,20,3,23,1.129388128106485
artificial_language_g0_82,artificial,7,2,9,1.3478911810460905
artificial_language_g0_83,artificial,16,3,19,1.1996831089870763
artificial_language_g0_84,artificial,9,3,12,1.5896971899410317
artificial_language_g0_85,artificial,16,7,23,1.2318371719805856
artificial_language_g0_86,artificial,27,2,29,1.0460361141382644
artificial_language_g0_87,artificial,22,2,24,1.0507005450490232
artificial_language_g0_88,artificial,10,2,12,1.3927194578576054
artificial_language_g0_89,artificial,12,1,13,1.1799193008539015
artificial_language_g0_90,artificial,12,0,12,1.209214068727997
artificial_language_g0_91,artificial,15,0,15,1.175500004658845
artificial_language_g0_92,artificial,13,7,20,1.6302800729398057
artificial_language_g0_93,artificial,10,4,14,1.3858193968721382
artificial_language_g0_94,artificial,14,0,14,1.109686272802097
artificial_language_g0_95,artificial,13,0,13,1.1504733844603887
artificial_language_g0_96,artificial,26,0,26,1.0579003733523515
artificial_language_g0_97,artificial,25,0,25,1.0597888839358038
artificial_language_g0_98,artificial,4,0,4,1.6037181657049668
artificial_language_g0_99,artificial,7,0,7,1.5802002665318182
artificial_language_g0_100,artificial,19,5,24,1.2146380150089304
artificial_language_g0_101,artificial,24,0,24,1.0529039747186977
artificial_language_g0_102,artificial,24,2,26,1.058756140231125
artificial_language_g0_103,artificial,25,2,27,1.0585381545069286
artificial_language_g0_104,artificial,14,2,16,1.1645002795633201
artificial_language_g0_105,artificial,14,0,14,1.2045619340026343
artificial_language_g0_106,artificial,17,0,17,1.1576442618917075
artificial_language_g0_107,artificial,24,4,28,1.1083321311313974
artificial_language_g0_108,artificial,23,0,23,1.0624386721998371
artificial_language_g0_109,artificial,23,0,23,1.0705370984049711
artificial_language_g0_110,artificial,12,2,14,1.1198054197632141
artificial_language_g0_111,artificial,12,0,12,1.390265166025232
artificial_language_g0_112,artificial,11,0,11,1.2048004035054423
artificial_language_g0_113,artificial,19,0,19,1.0996455350652246
artificial_language_g0_114,artificial,14,0,14,1.1615770616284316
artificial_language_g0_115,artificial,26,0,26,1.0553370721794348
artificial_language_g0_116,artificial,21,2,23,1.069224950940948
artificial_language_g0_117,artificial,17,0,17,1.0952839171789446
artificial_language_g0_118,artificial,19,0,19,1.0953837452215165
artificial_language_g0_119,artificial,7,0,7,1.2941338462498502
artificial_language_g0_120,artificial,14,7,21,1.3413921407831937
artificial_language_g0_121,artificial,11,2,13,1.1956785225043085
artificial_language_g0_122,artificial,25,2,27,1.0560772917195744
artificial_language_g0_123,artificial,22,2,24,1.0589165871226434
artificial_language_g0_124,artificial,26,0,26,1.0507196142829598
artificial_language_g0_125,artificial,8,0,8,1.9528112909372377
artificial_language_g0_126,artificial,23,5,28,1.1038236468444396
artificial_language_g0_127,artificial,11,0,11,1.1374521963907043
artificial_language_g0_128,artificial,21,2,23,1.062062681531987
artificial_language_g0_129,artificial,28,0,28,1.0422895142800666
artificial_language_g0_130,artificial,14,2,16,1.119391001690925
artificial_language_g0_131,artificial,9,4,13,1.4727915707753174
artificial_language_g0_132,artificial,12,1,13,1.1405434832634194
artificial_language_g0_133,artificial,8,4,12,1.617789053040361
artificial_language_g0_134,artificial,23,2,25,1.1032308570259002
artificial_language_g0_135,artificial,24,2,26,1.0482397083398127
artificial_language_g0_136,artificial,17,2,19,1.1077606082225853
artificial_language_g0_137,artificial,19,0,19,1.1097605134499546
artificial_language_g0_138,artificial,16,2,18,1.1382414313807532
artificial_language_g0_139,artificial,22,2,24,1.0735270116372235
artificial_language_g0_140,artificial,14,2,16,1.100261782019239
artificial_language_g0_141,artificial,9,7,16,1.5125672733962379
artificial_language_g0_142,artificial,13,0,13,1.2507195867983065
artificial_language_g0_143,artificial,25,0,25,1.050697034472918
artificial_language_g0_144,artificial,6,2,8,1.450448864630013
artificial_language_g0_145,artificial,27,2,29,1.049974682475495
artificial_language_g0_146,artificial,11,6,17,1.3942279285123103
artificial_language_g0_147,artificial,13,5,18,1.2787994152372741
artificial_language_g0_148,artificial,8,0,8,1.6046525717084985
artificial_language_g0_149,artificial,13,7,20,1.2234530672803514
artificial_language_g0_150,artificial,7,0,7,1.5942358654021858
artificial_language_g0_151,artificial,22,0,22,1.0742721364462007
artificial_language_g0_152,artificial,11,2,13,1.2461448856012995
artificial_language_g0_153,artificial,9,3,12,1.764035954994815
artificial_language_g0_154,artificial,17,0,17,1.1458482700029353
artificial_language_g0_155,artificial,25,2,27,1.1050186752493276
artificial_language_g0_156,artificial,9,1,10,1.202727433927109
artificial_language_g0_157,artificial,5,1,6,1.728842369812931
artificial_language_g0_158,artificial,18,0,18,1.1076951598535356
artificial_language_g0_159,artificial,20,2,22,1.0703237913625774
artificial_language_g0_160,artificial,27,5,32,1.095012801056861
artificial_language_g0_161,artificial,11,2,13,1.4563526320430513
artificial_language_g0_162,artificial,14,6,20,1.3535049661802088
artificial_language_g0_163,artificial,21,5,26,1.179208706433781
artificial_language_g0_164,artificial,9,0,9,1.2984781851651808
artificial_language_g0_165,artificial,10,0,10,1.4009364828271478
artificial_language_g0_166,artificial,19,0,19,1.0962611032372849
artificial_language_g0_167,artificial,13,0,13,1.2090956211570398
artificial_language_g0_168,artificial,15,0,15,1.1238427339561805
artificial_language_g0_169,artificial,12,2,14,1.1544991426361726
artificial_language_g0_170,artificial,21,0,21,1.0726430765909738
artificial_language_g0_171,artificial,25,7,32,1.1093947103900432
artificial_language_g0_172,artificial,16,0,16,1.1497882478356778
artificial_language_g0_173,artificial,27,2,29,1.0497595674620763
artificial_language_g0_174,artificial,16,6,22,1.2531531041290995
artificial_language_g0_175,artificial,5,0,5,1.5875559838316244
artificial_language_g0_176,artificial,11,0,11,1.2011830514867516
artificial_language_g0_177,artificial,11,2,13,1.206138235561805
artificial_language_g0_178,artificial,18,2,20,1.077997478291086
artificial_language_g0_179,artificial,14,3,17,1.2041851145853495
artificial_language_g0_180,artificial,26,1,27,1.0574203040020502
artificial_language_g0_181,artificial,11,4,15,1.5712139038816753
artificial_language_g0_182,artificial,16,0,16,1.1120669789662998
artificial_language_g0_183,artificial,19,4,23,1.1557904031223483
artificial_language_g0_184,artificial,18,2,20,1.1664513895568214
artificial_language_g0_185,artificial,25,4,29,1.0818924666706742
artificial_language_g0_186,artificial,27,2,29,1.0487882152895747
artificial_language_g0_187,artificial,23,0,23,1.0729083617913964
artificial_language_g0_188,artificial,6,7,13,2.365066841309529
artificial_language_g0_189,artificial,30,5,35,1.0786726484036953
artificial_language_g0_190,artificial,11,2,13,1.3115555198347355
artificial_language_g0_191,artificial,20,4,24,1.1047368293506168
artificial_language_g0_192,artificial,21,0,21,1.0798719494037614
artificial_language_g0_193,artificial,26,0,26,1.0630980698236123
artificial_language_g0_194,artificial,26,0,26,1.0549007647885233
artificial_language_g0_195,artificial,23,1,24,1.0692993785179095
artificial_language_g0_196,artificial,19,1,20,1.0831818637610964
artificial_language_g0_197,artificial,24,2,26,1.0541468443758566
artificial_language_g0_198,artificial,27,2,29,1.0795923332087871
artificial_language_g0_199,artificial,19,0,19,1.1017468473222118
artificial_language_g0_200,artificial,24,0,24,1.0662257315552486
artificial_language_g0_201,artificial,28,5,33,1.0956884739116972
artificial_language_g0_202,artificial,22,0,22,1.0692816700992906
artificial_language_g0_203,artificial,21,5,26,1.1700162021374199
artificial_language_g0_204,artificial,20,0,20,1.0968750860749332
artificial_language_g0_205,artificial,14,0,14,1.1299723190505337
artificial_language_g0_206,artificial,16,0,16,1.1184757085909058
artificial_language_g0_207,artificial,23,0,23,1.0710422298471338
artificial_language_g0_208,artificial,18,0,18,1.0725390708806755
artificial_language_g0_209,artificial,8,0,8,1.3036844264718825
artificial_language_g0_210,artificial,19,1,20,1.0725695790534626
artificial_language_g0_211,artificial,22,0,22,1.084719377144394
artificial_language_g0_212,artificial,10,5,15,1.332478086248253
artificial_language_g0_213,artificial,26,2,28,1.0987022075371464
artificial_language_g0_214,artificial,7,2,9,1.3431375266129586
artificial_language_g0_215,artificial,11,2,13,1.3141249399811208
artificial_language_g0_216,artificial,23,2,25,1.0587554311314025
artificial_language_g0_217,artificial,12,0,12,1.1852551008975571
artificial_language_g0_218,artificial,10,2,12,1.1505342914437733
artificial_language_g0_219,artificial,20,5,25,1.1779582016715722
artificial_language_g0_220,artificial,22,2,24,1.0579146361975498
artificial_language_g0_221,artificial,11,2,13,1.2282897040678897
artificial_language_g0_222,artificial,13,5,18,1.3222743304017064
artificial_language_g0_223,artificial,25,3,28,1.1141220965954908
artificial_language_g0_224,artificial,9,0,9,1.3651927067806349
artificial_language_g0_225,artificial,13,0,13,1.2386278204487244
artificial_language_g0_226,artificial,9,0,9,1.2688307133277288
artificial_language_g0_227,artificial,13,4,17,1.334677044280712
artificial_language_g0_228,artificial,8,0,8,1.447113102620368
artificial_language_g0_229,artificial,23,2,25,1.0666922672242913
artificial_language_g0_230,artificial,10,0,10,1.2492827059980978
artificial_language_g0_231,artificial,13,0,13,1.1826549472964079
artificial_language_g0_232,artificial,24,2,26,1.0490021480695293
artificial_language_g0_233,artificial,18,3,21,1.2042572108208647
artificial_language_g0_234,artificial,17,6,23,1.2005240219733684
artificial_language_g0_235,artificial,11,5,16,1.701858483362629
artificial_language_g0_236,artificial,26,0,26,1.0523621047000185
artificial_language_g0_237,artificial,23,0,23,1.0524408565918018
artificial_language_g0_238,artificial,20,2,22,1.065840760069334
artificial_language_g0_239,artificial,19,0,19,1.0827751215036252
artificial_language_g0_240,artificial,11,0,11,1.2190344544498608
artificial_language_g0_241,artificial,25,5,30,1.098065669977392
artificial_language_g0_242,artificial,24,5,29,1.1228975931809746
artificial_language_g0_243,artificial,10,2,12,1.4057678660170319
artificial_language_g0_244,artificial,24,2,26,1.0515432974743328
artificial_language_g0_245,artificial,18,0,18,1.116706810236363
artificial_language_g0_246,artificial,12,2,14,1.2883093189346027
artificial_language_g0_247,artificial,20,0,20,1.0920149542404607
artificial_language_g0_248,artificial,23,3,26,1.1078172496491592
artificial_language_g0_249,artificial,18,0,18,1.1043825275340415
artificial_language_g0_250,artificial,16,0,16,1.1059282104114467
artificial_language_g0_251,artificial,22,3,25,1.1125074617336106
artificial_language_g0_252,artificial,22,1,23,1.0621109329931926
artificial_language_g0_253,artificial,5,0,5,1.4326016448688361
artificial_language_g0_254,artificial,23,0,23,1.0579190008461379
artificial_language_g0_255,artificial,10,0,10,1.1682525230430436
artificial_language_g0_256,artificial,14,0,14,1.131126592707436
artificial_language_g0_257,artificial,11,2,13,1.1839837919693144
artificial_language_g0_258,artificial,8,0,8,1.5745384067273924
artificial_language_g0_259,artificial,15,0,15,1.0965903776343062
artificial_language_g0_260,artificial,8,0,8,1.4711528762830723
artificial_language_g0_261,artificial,7,4,11,1.3712557788908564
artificial_language_g0_262,artificial,24,0,24,1.0667956844577204
artificial_language_g0_263,artificial,15,0,15,1.1308025737711884
artificial_language_g0_264,artificial,9,2,11,1.2954094309216977
artificial_language_g0_265,artificial,25,4,29,1.1038817615236112
artificial_language_g0_266,artificial,18,0,18,1.0817078991244173
artificial_language_g0_267,artificial,15,0,15,1.1177202768420087
artificial_language_g0_268,artificial,6,2,8,1.4940180786123505
artificial_language_g0_269,artificial,14,0,14,1.1101628645991717
artificial_language_g0_270,artificial,12,0,12,1.2286226438149062
artificial_language_g0_271,artificial,13,0,13,1.2057140581465795
artificial_language_g0_272,artificial,27,5,32,1.104267707214674
artificial_language_g0_273,artificial,23,2,25,1.050381242030969
artificial_language_g0_274,artificial,19,2,21,1.0974437759172302
artificial_language_g0_275,artificial,10,0,10,1.4119217821371315
artificial_language_g0_276,artificial,11,0,11,1.2127836215531622
artificial_language_g0_277,artificial,14,0,14,1.145492311560165
artificial_language_g0_278,artificial,12,0,12,1.1463417772788294
artificial_language_g0_279,artificial,25,0,25,1.0485321166431036
artificial_language_g0_280,artificial,23,0,23,1.0685436925176521
artificial_language_g0_281,artificial,20,0,20,1.072707188577864
artificial_language_g0_282,artificial,24,0,24,1.056622439757933
artificial_language_g0_283,artificial,9,0,9,1.497652339216517
artificial_language_g0_284,artificial,8,0,8,1.3263945069191978
artificial_language_g0_285,artificial,6,1,7,1.3835538120800017
artificial_language_g0_286,artificial,19,7,26,1.1889956527355294
artificial_language_g0_287,artificial,10,0,10,1.2283044171631445
artificial_language_g0_288,artificial,24,0,24,1.0595084152049163
artificial_language_g0_289,artificial,7,0,7,1.3916583098318747
artificial_language_g0_290,artificial,18,2,20,1.078435687145178
artificial_language_g0_291,artificial,26,2,28,1.050521853252406
artificial_language_g0_292,artificial,16,2,18,1.1305876435854672
artificial_language_g0_293,artificial,16,2,18,1.110275486536925
artificial_language_g0_294,artificial,23,7,30,1.1233377047043451
artificial_language_g0_295,artificial,25,2,27,1.0974282513162021
artificial_language_g0_296,artificial,23,3,26,1.102880499028227
artificial_language_g0_297,artificial,17,0,17,1.1431047637577907
artificial_language_g0_298,artificial,27,0,27,1.0458465426492887
artificial_language_g0_299,artificial,20,0,20,1.0900177035703542
